w;w;w;w;w;w;w;w;w;w;w
w;;;;;;;;;;w
w;;;;;;;;h;;w
w;;;;;c;;;;;w
w;;;;;;;;;;w
w;;d(teste);;;;;b(teste);f;;w
w;;;;;;;;;;w
w;;;;;;;;;;w
w;;;;;;;;;;w
w;;;;;;;;;;w
w;;;;;;;;;;w
w;w;w;w;w;w;w;w;w;w;w
