w,w,w,w,w,w,w,w,w,w,w,w,w,w,w,w,w,w,w
w,,,,,,,,,,,w,w,w,w,w,w,w,w
w,w,w,,w,w,w,w,w,w,,,,,,,,,w
w,,w,,w,,,,,w,w,w,w,w,w,w,w,,w
w,,w,,w,w,w,w,,,,,,,,,w,,w
w,,w,,,,,w,w,w,w,,w,w,w,w,w,,w
w,,w,,w,w,,,,,,,w,,,,w,,w
w,,w,,,w,w,w,w,w,w,,w,,w,,w,,w
w,,w,w,,w,,,,,w,,w,f,w,,w,,w
w,,,,,w,,w,w,w,w,,w,w,w,,w,,w
w,,w,,w,w,,,,,,,,,,,,,w
w,w,w,w,w,w,w,w,w,w,w,w,w,w,w,w,w,w,w
